0	0	0	0	0	0	0	0	0	0	0	8	0	0	0	0	0	0	0	0	0	0	0	0	0	0	0	0	0	0	0	0	0	0	0	0	0	4	4	4	4	4	0	0	0	0	0	0	0	0	0	0	0	0	0	0	0	0	0	0	0	0	0	0	0	0	0	0	0	0	0	0	0	0	0	0	0	0	0	0	0	0	0	0	0	0	0	0	0	0	0	0	0	0	0	0	0	0	0	0
0	0	0	0	0	0	0	0	0	0	0	8	0	0	0	0	0	0	0	0	0	0	0	0	0	0	0	0	0	0	0	0	0	0	0	0	0	4	4	4	4	4	0	0	0	0	0	0	0	0	0	0	0	0	0	0	0	0	0	0	0	0	0	0	0	0	0	0	0	0	0	0	0	0	0	0	0	0	0	0	0	0	0	0	0	0	0	0	0	0	0	0	0	0	0	0	0	0	0	0
0	0	0	0	0	0	0	0	0	0	0	8	0	0	0	0	0	0	0	0	0	0	0	0	0	0	0	0	0	0	0	0	0	0	0	0	0	4	4	4	4	4	0	0	0	0	0	0	0	0	0	0	0	0	0	0	0	0	0	0	0	0	0	0	0	0	0	0	0	0	0	0	0	0	0	0	0	0	0	0	0	0	0	0	0	0	0	0	0	0	0	0	0	0	0	0	0	0	0	0
0	0	0	0	0	0	0	0	0	0	0	8	0	0	0	0	0	0	0	0	0	0	0	0	0	0	0	0	0	0	0	0	0	0	0	0	0	4	4	4	4	4	0	0	0	0	0	0	0	0	0	0	0	0	0	0	0	0	0	0	0	0	0	0	0	0	0	0	0	0	0	0	0	4	4	4	4	4	4	4	4	4	4	4	4	4	4	4	4	4	4	4	4	0	0	0	0	0	0	0
0	0	0	0	0	0	0	0	0	0	0	8	0	0	0	0	0	0	0	0	0	0	0	0	0	0	0	0	0	0	0	0	0	0	0	0	0	4	4	4	4	4	0	0	0	0	0	0	0	0	0	0	0	0	0	0	0	0	0	0	0	0	2	2	2	2	2	2	2	2	2	2	2	4	4	4	4	4	4	4	4	4	4	4	4	4	4	4	4	4	4	4	4	0	0	0	0	0	0	0
0	0	0	0	0	0	0	0	0	0	0	8	0	0	0	0	0	0	0	9	9	0	0	0	0	0	0	0	0	0	0	0	0	0	0	0	0	4	4	4	4	4	0	0	0	0	0	0	0	0	0	0	0	0	0	0	0	0	0	0	0	0	2	2	2	2	2	2	2	2	2	2	2	4	4	4	4	4	4	4	4	4	4	4	4	4	4	4	4	4	4	4	4	0	0	0	0	0	0	0
0	0	0	0	0	0	0	0	0	0	0	8	7	7	7	7	8	0	0	9	9	0	0	0	0	0	0	0	0	0	0	0	0	0	0	0	0	4	4	4	4	4	0	0	0	0	0	0	0	0	0	0	0	0	0	0	0	0	0	0	0	0	2	2	2	2	2	2	2	2	2	2	2	4	4	4	4	4	4	4	4	4	4	4	4	4	4	4	4	4	4	4	4	0	0	0	0	0	0	0
0	0	0	0	0	0	0	0	0	0	0	8	7	7	7	7	8	0	0	9	9	0	0	0	0	0	0	0	0	0	0	0	0	0	0	0	0	4	4	4	4	4	0	0	0	0	0	0	0	0	0	0	0	0	0	0	0	0	0	0	0	0	2	2	2	2	2	2	2	2	2	2	2	4	4	4	4	4	4	4	4	4	4	4	4	4	4	4	4	4	4	4	4	0	0	0	0	0	0	0
0	0	0	0	0	0	0	0	0	0	0	8	7	7	7	7	8	0	0	0	0	0	0	0	0	0	0	0	0	0	0	0	0	0	0	0	0	4	4	4	4	4	0	0	0	0	0	0	0	0	0	0	0	0	0	0	0	0	0	0	0	0	2	2	2	2	2	2	2	2	2	2	2	4	4	4	4	4	4	4	4	4	4	4	4	4	4	4	4	4	4	4	4	0	0	0	0	0	0	0
0	0	0	0	0	0	0	0	0	0	0	8	7	7	7	7	8	0	0	0	0	0	0	0	0	0	0	0	0	0	0	0	0	0	0	0	0	4	4	4	4	4	0	0	0	0	0	0	0	9	9	9	0	0	0	0	0	0	0	0	0	0	2	2	2	2	2	2	2	2	2	2	2	4	4	4	4	4	4	4	4	4	4	4	4	4	4	4	4	4	4	4	4	0	0	0	0	0	0	0
0	0	0	0	0	0	0	0	0	0	0	8	7	7	7	7	8	0	0	0	0	0	0	0	0	0	0	0	4	4	4	4	4	4	4	4	0	4	4	4	4	4	0	0	0	0	0	0	0	9	9	9	0	0	0	0	0	0	0	0	0	0	2	2	2	2	2	2	2	2	2	2	2	4	4	4	4	4	4	4	4	4	4	4	4	4	4	4	4	4	4	4	4	0	0	0	0	0	0	0
0	0	0	0	0	0	0	0	0	0	0	8	7	7	7	7	8	0	0	0	0	0	0	0	0	0	0	0	4	4	4	4	4	4	4	4	0	4	4	4	4	4	0	0	0	0	0	0	0	9	9	9	0	0	0	0	0	0	0	0	0	0	2	2	2	2	2	2	2	2	2	2	2	4	4	4	4	4	4	4	4	4	4	4	4	4	4	4	4	4	4	4	4	0	0	0	0	0	0	0
0	0	0	0	0	0	0	0	0	0	0	8	7	7	7	7	8	0	0	0	0	0	0	0	0	0	0	0	4	4	4	4	4	4	4	4	0	4	4	4	4	4	0	0	0	0	0	0	0	9	9	9	0	0	0	0	0	0	0	0	0	0	2	2	2	2	2	2	2	2	2	2	2	4	4	4	4	4	4	4	4	4	4	4	4	4	4	4	4	4	4	4	4	0	0	0	0	0	0	0
0	0	0	0	0	0	0	0	0	7	7	8	7	7	7	7	8	0	0	0	1	1	1	1	1	1	0	0	4	4	4	4	4	4	4	4	0	4	4	4	4	4	0	0	0	0	0	0	0	9	9	9	0	0	0	0	0	0	0	0	0	0	2	2	2	2	2	2	2	2	2	2	2	4	4	4	4	4	4	4	4	4	4	4	4	4	4	4	4	4	4	4	4	0	0	0	0	0	0	0
0	0	0	0	0	0	0	0	0	7	7	8	7	7	7	7	8	0	0	0	1	1	1	1	1	1	0	0	4	4	4	4	4	4	4	4	0	4	4	4	4	4	0	0	0	0	0	0	0	9	9	9	0	0	0	0	0	0	0	0	0	0	2	2	2	2	2	2	2	2	2	2	2	4	4	4	4	4	4	4	4	4	4	4	4	4	4	4	4	4	4	4	4	0	0	0	0	0	0	0
0	0	0	0	0	0	0	0	0	7	7	6	6	7	7	7	8	0	0	0	1	1	1	1	1	1	0	0	4	4	4	4	4	4	4	4	0	4	4	4	4	4	0	0	0	0	0	0	0	9	9	9	0	0	0	0	0	0	0	0	0	0	2	2	2	2	2	2	2	2	2	2	2	4	4	4	4	4	4	4	9	9	9	9	9	4	4	4	4	4	4	4	4	0	0	0	0	0	0	0
0	0	0	0	0	0	0	0	0	7	7	7	6	7	7	7	8	0	0	0	1	1	1	1	1	1	0	0	4	4	4	4	4	4	4	4	0	0	0	0	0	0	0	0	0	0	0	0	0	0	0	0	0	0	0	0	0	0	0	0	0	0	2	2	2	2	2	2	2	2	2	2	2	4	4	4	4	4	4	4	9	9	9	9	9	4	4	4	4	4	4	4	4	0	0	0	0	0	0	0
0	0	0	0	0	0	0	0	0	7	7	7	6	6	7	7	8	0	0	0	1	1	1	1	1	1	0	0	4	4	4	4	4	4	4	4	0	0	0	0	0	0	0	0	0	0	0	0	0	0	0	0	0	0	0	0	0	0	0	0	0	0	2	2	2	2	2	2	2	2	2	2	2	4	4	4	4	4	4	4	9	9	9	9	9	4	4	4	4	4	4	4	4	0	0	0	0	0	0	0
0	0	0	0	0	0	0	0	0	7	7	7	7	6	6	7	8	0	0	0	1	1	1	1	1	1	0	0	4	4	4	4	4	4	4	4	0	0	0	0	0	0	0	0	0	0	0	0	0	0	0	0	0	0	0	0	0	0	0	0	0	0	2	2	2	2	2	2	2	2	2	2	2	4	4	4	4	4	4	4	9	9	9	9	9	4	4	4	4	4	4	4	4	0	0	0	0	0	0	0
0	0	0	0	0	0	0	0	0	7	7	7	7	7	6	7	8	0	0	0	1	1	1	1	1	1	0	0	4	4	4	4	4	4	4	4	0	0	0	0	0	0	0	0	0	0	0	0	0	0	0	0	0	0	0	0	0	0	0	0	0	0	2	2	2	2	2	2	2	2	2	2	2	4	4	4	4	4	4	4	9	9	9	9	9	4	4	4	4	4	4	4	4	0	0	0	0	0	0	0
0	0	0	0	0	0	0	0	0	0	7	7	7	7	6	7	8	0	0	0	1	1	1	1	1	1	0	0	4	4	4	4	4	4	4	4	0	0	0	0	0	0	0	0	0	0	0	0	0	0	0	0	0	0	0	0	0	0	0	0	0	0	0	0	0	0	0	0	0	0	0	0	0	4	4	4	4	4	4	4	9	9	9	9	9	4	4	4	4	4	4	4	4	0	0	0	0	0	0	0
0	0	0	0	0	0	0	0	0	0	7	7	7	7	8	0	8	0	0	0	1	1	1	1	1	1	0	0	4	4	4	4	4	4	4	4	0	0	0	0	0	0	0	0	0	0	0	0	0	8	0	0	0	0	0	0	0	0	0	0	0	0	0	0	0	0	0	0	0	0	0	0	0	4	4	4	4	4	4	4	9	9	9	9	9	4	4	4	4	4	4	4	4	0	0	0	0	0	0	0
0	0	0	0	0	0	0	0	0	0	7	7	7	7	8	0	8	0	0	0	1	1	1	1	1	1	0	0	4	4	4	4	4	4	4	4	0	0	0	0	0	0	0	0	0	0	0	0	0	8	0	0	0	0	0	0	0	0	0	0	0	0	0	0	0	0	0	0	0	0	0	0	0	4	4	4	4	4	4	4	9	9	9	9	9	4	4	4	4	4	4	4	4	0	0	0	0	0	0	0
0	0	0	0	0	0	0	0	0	0	7	7	7	7	8	0	8	0	0	0	1	1	1	1	1	1	0	0	4	4	4	4	4	4	4	4	0	0	0	0	0	0	0	0	0	0	0	0	0	8	0	0	0	0	0	0	0	0	0	0	1	1	1	1	1	1	0	0	0	0	0	0	0	4	4	4	4	4	4	4	9	9	9	9	9	4	4	4	4	4	4	4	4	0	0	0	0	0	0	0
0	0	0	0	0	0	0	0	0	0	7	7	7	7	8	0	0	0	0	0	1	1	1	1	1	1	0	0	4	4	4	4	4	4	4	4	0	0	0	0	0	0	0	0	0	0	0	0	0	8	0	0	0	0	0	0	0	0	0	0	1	1	1	1	1	1	0	0	0	0	0	0	0	4	4	4	4	4	4	4	9	9	9	9	9	4	4	4	4	4	4	4	4	0	0	0	0	0	0	0
0	0	0	0	0	0	0	0	0	0	7	7	7	7	8	0	0	0	0	0	1	1	1	1	1	1	0	0	4	4	4	4	4	4	4	4	0	0	0	0	0	0	0	0	0	0	0	0	0	8	0	0	0	0	0	0	0	0	0	0	1	1	1	1	1	1	0	0	0	0	0	0	0	4	4	4	4	4	4	4	9	9	9	9	9	4	4	4	4	4	4	4	4	0	0	0	0	0	0	0
0	0	0	0	0	0	0	0	0	0	7	7	7	7	8	0	0	0	0	0	1	1	1	1	1	1	0	0	4	4	4	4	4	4	4	4	0	0	0	0	0	0	0	0	0	0	0	0	0	8	0	0	0	0	0	0	0	0	0	0	1	1	1	1	1	1	0	0	0	0	0	0	0	4	4	4	4	4	4	4	9	9	9	9	9	4	4	4	4	4	4	4	4	0	0	0	0	0	0	0
0	0	0	0	0	0	0	0	0	0	0	0	0	0	8	0	0	0	0	0	1	1	1	1	1	1	0	0	4	4	4	4	4	4	4	4	0	0	0	0	0	0	0	0	0	0	0	0	0	8	0	0	0	0	0	0	0	0	0	0	1	1	9	9	1	1	0	0	0	0	0	0	0	4	4	4	4	4	4	4	4	4	4	4	4	4	4	4	4	4	4	4	4	0	0	0	0	0	0	0
0	0	0	0	0	0	0	0	0	0	0	0	0	0	8	0	0	0	0	0	0	0	0	0	0	0	0	0	4	4	4	4	4	4	4	4	0	0	0	0	0	0	0	0	0	0	0	0	0	8	0	0	0	7	0	0	0	0	0	0	1	1	9	9	1	1	0	0	0	0	0	0	0	4	4	4	4	4	4	4	4	4	4	4	4	4	4	4	4	4	4	4	4	0	0	0	0	0	0	0
0	0	0	0	0	0	0	0	0	0	0	0	0	0	8	0	0	0	0	0	0	0	0	0	0	0	0	0	4	4	4	4	4	4	4	4	0	0	0	0	0	0	0	0	0	0	0	0	0	8	0	0	0	0	0	0	0	0	0	0	1	1	9	9	1	1	0	0	0	0	0	0	0	4	4	4	4	4	4	4	4	4	4	4	4	4	4	4	4	4	4	4	4	0	0	0	0	0	0	0
0	0	0	4	4	4	0	0	0	0	0	0	0	0	8	0	0	0	0	0	0	0	0	0	0	0	0	0	4	4	4	4	4	4	4	4	0	0	0	0	0	0	0	0	0	0	0	0	0	8	0	0	0	0	0	0	0	0	0	0	1	1	1	1	1	1	0	0	0	0	0	0	0	4	4	4	4	4	4	4	4	4	4	4	4	4	4	4	4	4	4	4	4	0	0	0	0	0	0	0
0	0	0	4	4	4	0	0	0	0	0	0	0	0	8	6	6	6	6	0	0	0	0	0	0	0	0	0	4	4	4	4	4	4	4	4	0	0	0	0	0	0	0	0	0	0	0	0	0	8	0	0	0	0	0	0	0	0	0	0	1	1	1	1	1	1	0	0	0	0	0	0	0	4	4	4	4	4	4	4	4	4	4	4	4	4	4	4	4	4	4	4	4	0	0	0	0	0	0	0
0	0	0	4	4	4	0	0	0	0	0	0	0	0	8	0	0	0	6	6	0	0	0	0	0	0	0	0	4	4	4	4	4	4	4	4	0	0	0	0	0	0	0	0	0	0	0	0	0	8	0	0	0	0	0	0	0	0	0	0	1	1	1	1	1	1	0	0	0	0	0	0	0	4	4	4	4	4	4	4	4	4	4	4	4	4	4	4	4	4	4	4	4	0	0	0	0	0	0	0
0	0	0	4	4	4	0	0	0	0	0	0	0	0	8	0	0	0	0	6	6	0	0	0	0	0	0	0	4	4	4	4	4	4	4	4	0	0	0	0	0	0	0	0	0	0	0	0	0	8	0	0	0	0	0	0	0	0	0	0	1	1	1	1	1	1	0	0	0	0	0	0	0	4	4	4	4	4	4	4	4	4	4	4	4	4	4	4	4	4	4	4	4	0	0	0	0	0	0	0
0	0	0	4	4	4	0	0	0	0	0	0	8	0	8	0	0	0	0	0	6	6	6	0	0	0	0	0	0	0	0	0	0	0	0	0	0	0	0	0	0	0	0	0	0	0	0	0	0	8	0	0	0	0	0	0	0	0	0	0	1	1	1	1	1	1	0	0	0	0	0	0	0	4	4	4	4	4	4	4	4	4	4	4	4	4	4	4	4	4	4	4	4	0	0	0	0	0	0	0
0	0	0	4	4	4	0	0	0	0	0	0	8	0	8	0	0	0	0	0	0	0	6	6	0	0	0	0	0	0	0	0	0	0	0	0	4	4	4	4	4	4	4	4	4	0	0	0	0	8	0	0	0	0	0	0	0	0	0	0	1	1	1	1	1	1	0	0	0	0	0	0	0	4	4	4	4	4	4	4	4	4	4	4	4	4	4	4	4	4	4	4	4	0	0	0	0	0	0	0
0	0	0	4	4	4	0	0	0	0	0	0	8	0	8	0	0	0	0	0	0	0	0	6	6	6	0	0	0	0	0	0	0	0	0	0	4	4	4	4	4	4	4	4	4	0	0	0	0	8	0	0	0	0	0	0	0	0	0	0	1	1	1	1	1	1	0	0	0	0	0	0	0	4	4	4	4	4	4	4	4	4	4	4	4	4	4	4	4	4	4	4	4	0	0	0	0	0	0	0
0	0	0	4	4	4	0	0	0	0	0	0	8	0	8	0	0	0	0	0	0	0	0	0	5	6	6	6	0	0	0	0	0	0	0	0	4	4	4	4	4	4	4	4	4	0	0	0	0	8	0	0	0	0	0	0	0	0	0	0	1	1	1	1	1	1	0	0	0	0	0	0	0	4	5	5	4	4	4	4	4	4	4	4	4	4	4	4	4	4	4	4	4	0	0	0	0	0	0	0
0	0	0	4	4	4	0	0	0	0	0	0	8	0	8	0	0	0	0	0	0	0	0	0	5	0	0	6	6	0	0	0	0	0	0	0	4	4	4	4	4	4	4	4	4	0	0	0	0	0	0	0	0	0	0	0	0	0	0	0	0	0	0	0	0	0	0	0	0	0	0	0	0	4	5	5	4	4	4	4	4	4	4	4	4	4	4	4	4	4	4	4	4	0	0	0	0	0	0	0
0	0	0	4	4	4	0	0	0	0	0	0	8	0	8	0	0	0	0	0	0	0	0	0	5	0	0	0	6	6	0	0	0	0	0	0	4	4	4	4	4	4	4	4	4	0	0	0	0	0	0	0	0	0	0	0	0	0	0	0	0	0	0	0	0	0	0	0	0	0	0	0	0	4	5	5	4	4	4	4	4	4	4	4	4	4	4	4	4	4	4	4	4	0	0	0	0	0	0	0
0	0	0	4	4	4	0	0	0	0	0	0	8	0	0	0	0	0	9	9	0	0	0	0	5	0	0	0	0	6	6	0	0	0	0	0	4	4	4	4	4	4	4	4	4	0	0	0	0	0	0	0	0	0	0	0	0	0	0	0	0	0	0	0	0	0	0	0	0	0	0	0	0	0	5	5	0	0	0	0	0	0	0	0	0	0	0	0	0	0	0	0	0	0	0	0	0	0	0	0
0	0	0	4	4	4	0	0	0	0	0	0	8	0	0	0	0	0	9	9	0	0	0	0	5	0	0	0	0	0	6	6	0	0	0	0	4	4	4	4	4	4	4	4	4	0	0	0	0	0	0	0	0	0	0	0	0	0	0	0	0	0	0	0	0	0	0	0	0	0	0	0	0	0	5	5	0	0	0	0	0	0	0	0	0	0	0	0	0	0	0	0	0	0	0	0	0	0	0	0
0	0	0	4	4	4	0	0	0	0	0	0	8	0	0	0	0	0	9	9	0	0	0	0	5	0	0	0	0	0	0	6	6	0	0	0	4	4	4	4	4	4	4	4	4	0	0	0	0	0	0	0	0	0	0	0	0	0	0	0	0	0	0	0	0	0	0	0	0	0	0	0	0	0	5	5	0	0	0	0	0	0	0	0	0	0	0	0	0	0	0	0	0	0	0	0	0	0	0	0
0	0	0	4	4	4	0	0	0	0	0	0	8	0	0	0	0	0	9	9	0	0	0	0	5	0	0	0	0	0	0	0	6	6	0	0	4	4	4	4	4	4	4	4	4	0	0	0	0	0	0	0	0	0	0	0	0	0	0	0	0	0	0	0	0	0	0	0	0	0	0	0	0	0	5	5	0	0	0	0	0	0	0	0	0	0	0	0	0	0	0	0	0	0	0	0	0	0	0	0
0	0	0	4	4	4	0	0	0	0	0	0	8	0	0	0	0	0	0	0	0	0	0	0	5	0	0	0	0	0	0	0	0	6	6	0	4	4	4	4	4	4	4	4	4	0	0	0	0	0	0	0	0	0	0	0	0	0	0	0	0	0	0	0	0	0	0	0	0	0	0	0	0	0	5	5	0	0	0	0	0	0	0	0	0	0	0	0	0	0	0	0	0	0	0	0	0	0	0	0
0	0	0	4	4	4	0	0	0	0	0	0	8	0	0	0	0	0	0	0	0	0	0	0	5	0	0	0	0	0	0	0	0	0	6	6	6	6	6	6	6	6	6	6	6	6	6	6	6	6	6	6	6	6	6	6	6	6	6	6	6	0	0	0	0	0	0	0	0	0	0	0	0	0	5	5	0	0	0	0	0	0	0	0	0	0	0	0	0	0	0	0	0	0	0	0	0	0	0	0
0	0	0	4	4	4	0	0	0	0	0	0	8	0	0	0	0	0	0	0	0	0	0	0	5	0	0	0	0	0	0	0	0	0	0	0	0	7	7	7	7	7	7	7	7	7	7	7	7	5	5	0	0	0	0	0	0	0	0	0	6	6	0	0	0	0	0	0	0	0	0	0	0	0	5	5	0	0	0	0	0	0	0	0	0	0	0	0	0	0	0	0	0	0	0	0	0	0	0	0
0	0	0	4	4	4	0	0	0	0	0	0	8	0	0	0	0	0	0	0	0	0	0	0	5	0	0	0	0	0	0	0	0	0	0	0	0	7	7	7	7	7	7	7	7	7	7	7	7	5	5	0	0	0	0	0	0	0	0	0	0	6	6	0	0	0	0	0	0	0	0	0	0	0	5	5	0	0	0	0	0	0	0	0	0	0	0	0	0	0	1	1	1	1	1	1	1	1	1	1
0	0	0	4	4	4	0	0	0	0	0	0	8	0	0	0	0	0	0	0	0	0	0	0	5	0	0	0	0	0	0	0	0	0	0	0	0	7	7	7	7	7	7	7	7	7	7	7	7	5	5	0	0	0	0	0	0	0	0	0	0	0	6	6	0	0	0	0	0	0	0	0	0	0	5	5	0	0	0	0	0	0	0	0	0	0	0	0	0	0	1	1	1	1	1	1	1	1	1	1
0	0	0	4	4	4	0	0	0	0	0	0	8	0	0	0	0	0	0	0	0	0	0	0	5	0	0	0	0	0	0	0	0	0	0	0	0	7	7	7	7	7	7	7	7	7	7	7	7	5	5	0	0	0	0	0	0	0	0	0	0	0	0	6	6	0	0	0	0	0	0	0	0	0	5	5	0	0	0	0	0	0	0	0	0	0	0	0	0	0	1	1	1	1	1	1	1	1	1	1
0	0	0	4	4	4	0	0	0	0	0	0	0	0	0	0	0	0	0	0	0	0	0	0	5	0	0	0	0	0	0	0	0	0	0	0	0	7	7	7	7	7	7	7	7	7	7	7	7	5	5	0	0	0	0	0	0	0	0	0	0	0	0	0	6	6	6	6	0	0	0	0	0	0	5	5	0	0	0	0	0	0	0	0	0	0	0	0	0	0	1	1	1	1	1	1	1	1	1	1
0	0	0	4	4	4	0	0	0	2	2	2	2	2	2	0	0	0	0	0	0	0	0	0	5	0	0	0	0	0	0	0	0	0	0	0	0	7	7	7	7	7	7	7	7	7	7	7	7	5	5	0	0	0	0	0	0	0	0	0	0	0	0	0	0	0	0	6	0	0	0	0	0	0	5	5	0	0	0	0	0	0	0	0	0	0	0	0	0	0	1	1	1	1	1	1	1	1	1	1
0	0	0	4	4	4	0	0	0	2	2	2	2	2	2	0	0	0	0	0	0	0	0	4	5	4	0	0	0	0	0	0	0	0	0	0	0	7	7	7	7	7	7	7	7	7	7	7	7	5	5	0	0	0	0	0	0	0	0	0	0	0	0	0	0	0	0	6	0	0	0	0	0	0	5	5	0	0	0	0	0	0	0	0	0	0	0	0	0	0	1	1	1	1	1	1	1	1	1	1
0	0	0	4	4	4	0	0	0	2	2	2	2	2	2	0	0	0	0	0	0	0	0	4	4	4	0	0	0	0	0	0	0	0	0	0	0	7	7	7	7	7	7	7	7	7	7	7	7	5	5	0	0	0	0	0	0	0	0	0	0	0	0	0	0	0	0	6	0	0	0	0	0	0	5	5	0	0	0	0	0	0	0	0	0	0	0	0	0	0	1	1	1	1	1	1	1	1	1	1
0	0	0	4	4	4	0	0	0	2	2	2	2	2	2	0	0	0	0	0	0	0	0	4	4	4	0	0	0	0	0	0	0	0	0	0	0	7	7	7	7	7	7	7	7	7	7	7	7	5	5	0	0	0	0	0	0	0	0	0	0	0	0	0	0	0	0	6	6	6	6	6	6	6	6	6	6	0	0	0	0	7	7	7	7	7	7	0	0	0	1	1	1	1	1	1	1	1	1	1
0	0	0	4	4	4	0	0	0	2	2	2	2	2	2	8	0	0	0	0	0	0	0	4	4	4	0	0	0	0	0	0	0	0	0	0	0	7	7	7	7	7	7	7	7	7	7	7	7	5	5	0	0	0	0	0	0	0	0	0	0	0	0	0	0	0	0	0	0	0	0	0	0	0	0	0	6	0	0	0	0	7	7	7	7	7	7	0	0	0	1	1	1	1	1	1	1	1	1	1
0	0	0	4	4	4	0	0	0	2	2	2	2	2	2	8	0	0	0	0	0	0	0	4	4	4	0	0	0	0	0	0	0	0	0	0	0	7	7	7	7	7	7	7	7	7	7	7	7	5	5	0	0	9	9	0	0	0	0	0	0	0	0	0	0	0	0	0	0	0	0	0	0	0	0	0	6	6	6	6	6	7	7	7	7	7	7	0	0	0	1	1	1	1	1	1	1	1	1	1
0	0	0	4	4	4	0	0	0	2	2	2	2	2	2	8	0	0	0	0	0	0	0	4	4	4	0	0	0	0	0	0	0	0	0	0	0	7	7	7	7	7	7	7	7	7	7	7	7	5	5	0	0	9	9	0	0	0	0	0	0	0	0	0	0	0	0	0	0	0	0	0	0	0	0	0	6	6	6	6	6	7	7	7	7	7	7	0	0	0	1	1	1	1	1	1	1	1	1	1
0	0	0	4	4	4	0	0	0	2	2	2	2	2	2	8	0	0	0	0	0	0	0	4	4	4	0	0	0	0	0	0	0	0	0	0	0	7	7	7	7	7	7	7	7	7	7	7	7	5	5	0	0	9	9	0	0	0	0	0	0	0	0	0	0	0	0	0	0	0	0	0	0	0	0	0	6	6	6	6	6	7	7	7	7	7	7	0	0	0	0	0	0	0	0	0	0	0	0	0
0	0	0	4	4	4	0	0	0	2	2	2	2	2	2	8	0	0	0	0	0	0	0	4	4	4	0	0	0	0	0	0	0	0	0	0	0	0	0	0	0	0	0	0	0	0	0	0	0	5	5	0	0	0	0	0	0	0	0	0	0	0	0	0	0	0	0	0	0	0	0	0	0	0	0	0	6	6	6	6	6	7	7	7	7	7	7	0	0	0	0	0	0	0	0	0	0	0	0	0
0	0	0	4	4	4	0	0	0	2	2	2	2	2	2	8	0	0	0	0	0	0	0	4	4	4	0	0	0	0	0	0	0	0	0	0	0	0	0	0	0	0	0	0	0	0	0	0	0	5	5	0	0	0	0	0	0	0	0	0	0	0	0	0	0	0	0	0	0	0	0	0	0	0	0	0	6	6	6	6	6	7	7	7	7	7	7	0	0	0	0	0	0	0	0	0	0	0	0	0
0	0	0	4	4	4	0	0	0	2	2	2	2	2	2	8	0	0	0	0	0	0	0	0	0	0	4	4	4	4	4	0	0	0	0	0	0	0	0	0	0	0	0	0	0	0	0	0	0	5	5	0	0	0	0	0	0	0	0	0	0	0	0	0	0	0	0	0	0	0	0	0	0	0	0	0	6	6	6	6	6	7	7	7	7	7	7	0	0	0	0	0	0	0	0	0	0	0	0	0
0	0	0	4	4	4	0	0	0	2	2	2	2	2	2	8	0	0	0	0	0	0	0	0	0	0	4	4	4	4	4	0	0	0	0	0	0	0	0	0	0	0	0	0	3	3	3	3	3	5	5	3	3	3	3	3	0	0	0	0	0	0	0	0	0	0	0	0	0	0	0	0	0	0	0	0	6	6	6	6	6	7	7	7	7	7	7	0	0	0	0	0	0	0	0	0	0	0	0	0
0	0	0	4	4	4	0	0	0	2	2	2	2	2	2	8	0	8	0	0	0	0	0	0	0	0	4	4	4	4	4	0	0	0	0	0	0	0	0	0	0	0	0	0	3	3	3	3	3	5	5	3	3	3	3	3	0	0	0	0	0	0	0	0	0	0	0	0	0	0	0	0	0	0	0	0	6	6	6	6	6	7	7	7	7	7	7	0	0	0	0	0	0	0	0	0	0	0	0	0
0	0	0	4	4	4	0	0	0	2	2	2	2	2	2	8	0	8	0	0	0	0	0	0	4	4	4	4	4	0	0	0	0	0	0	0	0	0	0	0	0	0	0	0	3	3	3	3	3	5	5	3	3	3	3	3	0	0	0	0	0	0	0	0	0	0	0	3	3	3	3	3	3	3	3	3	3	5	6	6	6	7	7	7	7	7	7	0	0	0	0	0	0	0	0	0	0	0	0	0
0	0	0	4	4	4	0	0	0	2	2	2	2	2	2	8	0	8	0	0	0	0	0	0	4	4	4	4	0	0	0	0	0	0	0	0	0	0	0	0	0	0	0	0	3	3	3	3	3	3	3	3	3	3	3	3	0	0	4	4	4	4	4	4	0	0	0	3	3	3	3	3	3	3	3	3	3	5	6	6	6	7	7	7	7	7	7	0	0	0	0	0	0	0	0	0	0	0	0	0
0	0	0	4	4	4	0	0	0	2	2	2	2	2	2	8	0	8	0	0	0	0	0	0	4	4	4	4	0	0	0	0	0	0	0	0	0	0	0	0	0	0	0	0	3	3	3	3	3	3	3	3	3	3	3	3	0	0	4	4	4	4	4	4	0	0	0	3	3	3	3	3	3	3	3	3	3	5	0	6	6	7	7	7	7	7	7	0	0	0	0	0	0	0	0	0	0	0	0	0
0	0	0	4	4	4	0	0	0	2	2	2	2	2	2	8	0	8	0	0	0	0	0	0	4	4	4	4	0	0	0	0	0	0	0	0	0	0	0	0	0	0	0	0	3	3	3	3	3	3	3	3	3	3	3	3	0	0	4	4	4	4	4	4	0	0	0	3	3	3	3	3	3	3	3	3	3	5	0	6	6	6	6	0	0	0	0	0	0	0	0	0	0	0	0	0	0	0	0	0
0	0	0	4	4	4	0	0	0	2	2	2	2	2	2	8	0	8	0	0	0	0	0	0	4	4	4	4	0	0	0	0	0	0	0	0	0	0	0	0	0	0	0	0	3	3	3	3	3	3	3	3	3	3	3	3	0	0	4	4	4	4	4	4	0	0	0	3	3	3	3	3	3	3	3	3	3	5	0	0	0	0	6	0	0	0	0	0	0	0	0	0	0	0	0	0	0	0	0	0
0	0	0	4	4	4	0	0	0	0	0	0	0	0	0	8	0	8	0	0	0	0	0	0	4	4	4	4	0	0	0	0	0	0	0	0	0	0	9	9	9	0	0	0	3	3	3	3	3	3	3	3	3	3	3	3	0	0	4	4	4	4	4	4	0	0	0	3	3	3	3	3	3	3	3	3	3	5	0	0	0	0	6	0	0	0	0	0	0	0	0	0	0	0	0	0	0	0	0	0
0	0	0	4	4	4	0	0	0	0	0	0	0	0	0	8	0	8	0	0	0	0	0	0	4	4	4	4	0	0	0	0	0	0	0	0	0	0	9	9	9	0	0	0	3	3	3	3	3	3	3	3	3	3	3	3	0	0	4	4	4	4	4	4	0	0	0	3	3	3	3	3	3	3	3	3	3	5	0	0	0	0	6	0	0	0	0	0	0	0	0	0	0	0	0	0	0	0	0	0
0	0	0	4	4	4	0	0	0	0	0	0	0	0	0	8	0	8	0	0	0	0	0	0	4	4	4	4	0	0	0	0	0	0	0	0	0	0	9	9	9	0	0	0	3	3	3	3	3	3	3	3	3	3	3	3	0	0	4	4	4	4	4	4	0	0	0	3	3	3	3	3	3	3	3	3	5	5	0	0	0	0	6	0	0	0	0	0	0	0	0	0	0	0	0	0	0	0	0	0
0	0	0	4	4	4	0	0	0	0	0	0	0	0	0	0	0	8	0	0	0	0	0	0	4	4	4	4	0	0	0	0	0	0	0	0	0	0	9	9	9	0	0	0	3	3	3	3	3	3	3	3	3	3	3	3	0	0	4	4	4	4	4	4	0	0	0	3	3	3	3	3	3	3	3	5	5	3	0	0	0	0	6	0	0	0	0	0	0	0	0	0	0	0	0	0	0	0	0	0
0	0	0	4	4	4	0	0	0	0	0	0	0	0	0	0	0	8	0	0	0	0	0	0	4	4	4	4	0	0	0	0	0	0	0	0	0	0	9	9	9	0	0	0	3	3	3	3	3	3	3	3	3	3	3	3	0	0	4	4	4	4	4	4	0	0	0	3	3	3	3	3	3	3	5	5	3	3	0	0	0	0	6	0	0	0	0	0	0	0	0	0	0	0	0	0	0	0	0	0
0	0	0	4	4	4	0	0	0	0	0	0	0	0	0	0	0	8	0	0	0	0	0	0	4	4	4	4	1	1	1	1	1	1	1	1	0	0	9	9	9	0	0	0	3	3	3	3	3	3	3	3	3	3	3	3	0	0	4	4	4	4	4	4	0	0	0	3	3	3	3	3	3	5	5	3	3	3	0	0	0	0	6	0	0	0	0	0	0	0	0	0	0	0	0	0	0	0	0	0
0	0	0	4	4	4	0	0	0	0	0	0	0	0	0	0	0	8	0	0	8	0	0	0	4	4	4	4	1	1	1	1	1	1	1	1	0	0	9	9	9	0	0	0	3	3	3	3	3	3	3	3	3	3	3	3	0	0	4	4	4	4	4	4	0	0	0	3	3	3	3	3	5	5	3	3	3	3	0	0	0	0	6	6	0	0	0	0	0	0	0	0	0	0	0	0	0	0	0	0
0	0	0	4	4	4	0	0	0	0	0	0	8	0	0	0	0	8	0	0	8	0	0	0	4	4	4	4	1	1	1	1	1	1	1	1	0	0	9	9	9	0	0	0	3	3	3	3	3	3	3	3	3	3	3	3	0	0	4	4	4	4	4	4	0	0	0	3	3	3	3	3	3	3	3	3	3	3	0	0	0	0	0	6	6	0	0	0	0	0	0	0	0	0	0	0	0	0	0	0
0	0	0	4	4	4	0	0	0	0	0	0	0	0	0	0	0	8	0	0	8	0	0	0	4	4	4	4	1	1	1	1	1	1	1	1	0	0	0	0	0	0	0	0	3	3	3	3	3	3	3	3	3	3	3	3	0	0	4	4	4	4	4	4	0	0	0	3	3	3	3	3	3	3	3	3	3	3	0	0	0	0	0	0	6	6	0	0	0	0	0	0	0	0	0	0	0	0	0	0
0	0	0	4	4	4	0	0	0	0	0	0	0	0	0	0	0	8	0	0	8	0	0	0	4	4	4	4	1	1	1	1	1	1	1	1	0	0	0	0	0	0	0	0	3	3	3	3	3	3	3	3	3	3	3	3	0	0	4	4	4	4	4	4	0	0	0	3	3	3	3	3	3	3	3	3	3	3	0	0	0	0	0	0	0	6	6	0	0	0	0	0	0	0	0	0	0	0	0	0
0	0	0	4	4	4	0	0	0	0	0	0	0	0	0	0	0	8	0	0	8	0	0	0	4	4	4	4	1	1	1	1	1	1	1	1	0	0	0	0	0	0	0	0	3	3	3	3	3	3	3	3	3	3	3	3	0	0	4	4	4	4	4	4	0	0	0	3	3	3	3	3	3	3	3	3	3	3	0	0	0	0	0	0	0	0	6	6	0	0	0	0	0	0	0	0	0	0	0	0
0	0	0	4	4	4	0	0	0	0	0	0	0	0	0	0	0	8	0	0	8	0	0	0	4	4	4	4	1	1	1	1	1	1	1	1	0	0	0	0	0	0	0	0	3	3	3	3	3	3	3	3	3	3	3	3	0	0	4	4	4	4	4	4	0	0	0	3	3	3	3	3	3	3	3	3	3	3	0	0	0	0	0	0	0	0	0	6	6	0	0	0	0	0	0	0	0	0	0	0
0	0	0	4	4	4	0	0	0	0	0	0	0	0	0	0	0	8	0	0	8	0	0	0	4	4	4	4	1	1	4	4	4	4	1	1	0	0	0	0	0	0	0	0	3	3	3	3	3	3	3	3	3	3	3	3	0	0	0	0	0	0	0	0	0	0	0	3	3	3	3	3	3	3	3	3	3	3	0	0	0	0	0	0	0	0	0	0	6	6	0	0	0	0	0	0	0	0	0	0
0	0	0	4	4	4	0	0	0	0	0	0	0	0	0	0	0	0	0	0	8	0	0	0	4	4	4	4	1	1	4	4	4	4	1	1	0	0	0	0	0	0	0	0	3	3	3	3	3	3	3	3	3	3	3	3	0	0	0	0	0	0	0	0	0	0	0	3	3	3	3	3	3	3	3	3	3	3	0	0	0	0	0	0	0	0	0	0	0	6	6	6	6	6	6	6	6	6	6	6
0	0	0	4	4	4	0	0	0	0	0	0	0	0	0	0	0	0	0	0	8	0	0	0	0	0	0	0	1	1	4	4	4	4	1	1	0	0	0	0	0	0	0	0	3	3	3	3	3	3	3	3	3	3	3	3	0	0	0	0	0	0	0	0	0	0	0	3	3	3	3	3	3	3	3	3	3	3	0	0	0	0	0	0	0	0	0	0	0	0	0	0	0	0	0	0	0	0	0	0
0	0	0	4	4	4	0	0	0	0	0	0	0	0	0	0	0	0	0	0	8	0	0	0	0	0	0	0	1	1	4	4	4	4	1	1	0	0	0	0	0	0	0	0	3	3	3	3	3	3	3	3	3	3	3	3	0	0	0	0	0	0	0	0	0	0	0	3	3	3	3	3	3	3	3	3	3	3	0	0	0	0	0	0	0	0	0	0	0	0	0	0	0	0	0	0	0	0	0	0
0	0	0	4	4	4	0	0	0	0	0	0	0	0	0	0	0	0	0	0	8	0	0	0	0	0	0	0	1	1	1	1	1	1	1	1	0	0	0	0	0	0	0	0	3	3	3	3	3	3	3	3	3	3	3	3	0	0	0	0	0	0	0	0	0	0	0	3	3	3	3	3	3	3	3	3	3	3	0	0	0	0	0	0	0	0	0	0	0	0	0	0	0	0	0	0	0	0	0	0
0	0	0	4	4	4	0	0	0	0	0	0	0	0	0	0	0	0	0	0	8	0	0	0	0	0	0	0	1	1	1	1	1	1	1	1	0	0	0	0	0	0	0	0	0	0	0	0	9	9	0	2	2	2	2	2	2	2	0	0	0	0	0	0	0	0	0	3	3	3	3	3	3	3	3	3	3	3	0	0	0	0	0	0	0	0	0	0	0	0	0	0	0	0	0	0	0	0	0	0
0	0	0	4	4	4	0	0	0	0	0	0	0	0	0	0	0	0	0	0	8	0	0	0	0	0	0	0	1	1	1	1	1	1	1	1	0	0	0	0	0	0	0	0	0	0	0	0	9	9	0	2	2	2	2	2	2	2	0	0	0	0	0	0	0	0	0	3	3	3	3	3	3	3	3	3	3	3	0	0	0	0	0	0	0	0	0	0	0	0	0	0	0	0	0	0	0	0	0	0
0	0	0	0	0	0	0	0	0	0	0	0	0	0	0	0	0	0	0	0	8	0	0	0	0	0	0	0	1	1	1	1	1	1	1	1	0	0	0	0	0	0	0	0	0	0	0	0	9	9	0	2	2	2	2	2	2	2	0	0	0	0	0	0	0	0	0	0	0	0	0	0	0	0	0	0	0	0	0	0	0	0	0	0	0	0	0	0	0	0	0	0	0	0	0	0	0	0	0	0
0	0	0	0	0	0	0	0	0	0	0	0	0	0	0	0	0	0	0	0	8	0	0	0	0	0	0	0	1	1	1	1	1	1	1	1	0	0	0	0	0	0	0	0	0	0	0	0	9	9	0	2	2	2	2	2	2	2	0	0	0	0	0	0	0	0	0	0	0	0	0	0	0	0	0	0	0	0	0	0	0	0	0	0	0	0	0	0	0	0	0	0	0	0	0	0	0	0	0	0
0	0	0	0	0	0	0	0	0	0	0	0	0	0	0	0	0	0	0	0	8	0	0	0	0	0	0	0	1	1	1	1	1	1	1	1	0	0	0	0	0	0	0	0	0	0	0	0	9	9	0	2	2	2	2	2	2	2	0	0	0	0	0	0	0	0	0	0	0	0	0	0	0	0	0	9	9	0	0	0	0	0	0	0	0	0	0	0	0	0	0	0	0	0	0	0	0	0	0	0
0	0	0	0	0	0	0	0	0	0	0	0	0	0	0	0	0	0	0	0	8	0	0	0	0	0	0	0	1	1	1	1	1	1	1	1	0	0	0	0	0	0	0	0	0	0	0	0	9	9	0	2	2	2	2	2	2	2	0	0	0	0	0	0	0	0	0	0	0	0	0	0	0	0	0	9	9	0	0	0	0	0	0	0	0	0	0	0	0	0	0	0	0	0	0	0	0	0	0	0
0	0	0	0	0	0	0	0	0	0	0	0	0	0	0	0	0	0	0	0	8	0	0	0	0	0	0	0	0	0	0	0	0	0	0	0	0	0	0	0	0	0	0	0	0	0	0	0	0	0	0	2	2	2	2	2	2	2	0	0	0	0	0	0	0	0	0	0	0	0	0	0	0	0	0	9	9	0	0	0	0	0	0	0	0	0	0	0	0	0	0	0	0	0	0	0	0	0	0	0
0	0	0	0	0	0	0	0	0	0	0	0	0	0	0	0	0	0	0	0	8	0	0	0	0	0	0	0	0	0	0	0	0	0	0	0	0	0	0	0	0	0	0	0	0	0	0	0	0	0	0	2	2	2	2	2	2	2	0	0	0	0	0	0	0	0	0	0	0	0	0	0	0	0	0	0	0	0	0	0	0	0	0	0	0	0	0	0	0	0	0	0	0	0	0	0	0	0	0	0
0	0	0	0	0	0	0	0	0	0	0	0	0	8	0	0	0	0	0	0	8	0	0	0	0	0	0	0	0	0	0	0	0	0	0	0	0	0	0	0	0	0	0	0	0	0	0	0	0	0	0	2	2	2	2	2	2	2	0	0	0	0	0	0	0	0	0	0	0	0	0	0	0	0	0	0	0	0	0	0	0	0	0	0	0	0	0	0	0	0	0	0	0	0	0	0	0	0	0	0
0	0	0	0	0	0	0	0	0	0	0	0	0	8	0	0	0	0	0	0	8	0	0	0	0	0	0	0	0	0	0	0	0	0	0	0	0	0	0	0	0	0	0	0	0	0	0	0	0	0	0	2	2	2	2	2	2	2	0	0	0	0	0	0	0	0	0	0	0	0	0	0	0	0	0	0	0	0	0	0	0	0	0	0	0	0	0	0	0	0	0	0	0	0	0	0	0	0	0	0
0	0	0	0	0	0	0	0	0	0	0	0	0	8	0	0	0	0	0	0	0	0	0	0	0	0	0	0	0	0	0	0	0	0	0	0	0	0	0	0	0	0	0	0	0	0	0	0	0	0	0	2	2	2	2	2	2	2	0	0	0	0	0	0	0	0	0	0	0	0	0	0	0	0	0	0	0	0	0	0	0	0	0	0	0	0	0	0	0	0	0	0	0	0	0	0	0	0	0	0
0	0	0	0	0	0	0	0	0	0	0	0	0	8	0	0	0	0	0	0	0	0	0	0	0	0	0	0	0	0	0	0	0	0	0	0	0	0	0	0	0	0	0	0	0	0	0	0	0	0	0	2	2	2	2	2	2	2	0	0	0	0	0	0	0	0	0	0	0	0	0	0	0	0	0	0	0	0	0	0	0	0	0	0	0	0	0	0	0	0	0	0	0	0	0	0	0	0	0	0
0	0	0	0	0	0	0	0	0	0	0	0	0	8	0	0	0	0	0	0	0	0	0	0	0	0	0	0	0	0	0	0	0	0	0	0	0	0	0	0	0	0	0	0	0	0	0	0	0	0	0	0	0	0	0	0	0	0	0	0	0	0	0	0	0	0	0	0	0	0	0	0	0	0	0	0	0	0	0	0	0	0	0	0	0	0	0	0	0	0	0	0	0	0	0	0	0	0	0	0
0	0	0	0	0	0	0	0	0	0	0	0	0	8	0	0	0	0	0	0	0	0	0	0	0	0	0	0	0	0	0	0	0	0	0	0	0	0	0	0	0	0	0	0	0	0	0	0	0	0	0	0	0	0	0	0	0	0	0	0	0	0	0	0	0	0	0	0	0	0	0	0	0	0	0	0	0	0	0	0	0	0	0	0	0	0	0	0	0	0	0	0	0	0	0	0	0	0	0	0
